аблютофобия (аблутофобия) — боязнь умывания, купания, стирки или чистки
авиафобия — боязнь полётов в воздушных транспортных средствах
агирофобия (дромофобия) — боязнь улиц, пересекать улицу
агорафобия — боязнь пространства, открытых мест, площадей, толп людей, рынков
аграфобия (контрелтофобия) — боязнь сексуальных домогательств, секса
айлурофобия (галеофобия, гатофобия, фелинофобия) — боязнь кошек
айхмофобия — боязнь острых предметов
аквафобия — боязнь воды, утопления,
акнефобия — боязнь появления угрей (акне)
акрофобия — боязнь высоты
акустикофобия (лигирофобия, фонофобия) — боязнь громких звуков
алгофобия — боязнь боли
амаксофобия — боязнь транспорта и вождения
аматофобия — боязнь пыли или загрязнения пылью
ангинофобия — боязнь приступа стенокардии
андрофобия — боязнь мужчин
анемофобия — боязнь бури (сильного ветра)
антофобия — боязнь цветов
антропофобия — боязнь людей или компании людей, форма социальной фобии
апейрофобия — боязнь бесконечности
апифобия — боязнь пчёл, ос; частный случай зоофобии
апопатофобия — боязнь заходить в туалеты
апоплексифобия — боязнь возникновения инсульта
арахнофобия — боязнь пауков; частный случай зоофобии
аритмофобия, арифмофобия — боязнь перед каким-либо индивидуально значимым числом
астрофобия — боязнь звёзд и звёздного пространства
атаксиофобия — боязнь нарушения координации движений
атихифобия — боязнь совершить ошибку, потерпеть неудачу
аурофобия — боязнь золота
аутомизофобия — боязнь загрязнить своё тело
аутофобия (ануптафобия, эремофобия, изолофобия) — боязнь одиночества
ахлуофобия — боязнь темноты
ацерофобия — боязнь кислых продуктов и напитков
аэрофобия — боязнь полётов на летательных аппаратах; также боязнь сквозняков
базофобия — боязнь ходьбы
бактериофобия (бациллофобия) — боязнь заразиться бактериями
баллистофобия — боязнь поражения пулей, бомбой или снарядом
барофобия — боязнь подъёма тяжести
блаптофобия — боязнь нанести кому-либо повреждение
бромгидрофобия (бромидрозифобия, бромидрофобия) — боязнь, что окружающие могут заметить неприятный запах тела или потливость страдающего данной фобией
бронтофобия — боязнь грома
вакцинофобия — боязнь прививок и связанных с ними неврологических осложнений
венерофобия (кипридофобия) — боязнь заразиться венерической болезнью
вербофобия — страх отдельных слов
верминофобия — боязнь бактерий, микробов, червей, заразиться
вертигофобия (динофобия) — боязнь головокружения
винофобия — боязнь употребления вина
галеофобия — боязнь акул
галитофобия — боязнь неприятного запаха изо рта
гамофобия — боязнь вступления в брак
гаптофобия (афефобия, гафефобия, гафофобия, гапнофобия, гаптефобия, тиксофобия) — боязнь прикосновения окружающих людей
гедонофобия — боязнь удовольствия, наслаждения
гексакосиойгексеконтагексафобия — страх числа 666
гелиофобия (гелеофобия) — боязнь солнца, солнечного света, страх пребывания на солнце
гелотофобия — страх оказаться объектом юмора, насмешек
гемофобия (гематофобия, гемафобия) — боязнь крови
генофобия, коитофобия, коитуфобия, миксеофобия, миксофобия — страх секса, сексуальных контактов
геронтофобия (гераскофобия) — страх общения с пожилыми людьми или собственного старения
герпетофобия — боязнь рептилий, пресмыкающихся, змей; частный случай зоофобии
гетерофобия — боязнь противоположного пола
гефирофобия — боязнь мостов
гидрозофобия — боязнь вспотеть
гидрофобия (аквафобия) — боязнь воды, сырости, жидкостей
гиерофобия — боязнь предметов религиозного культа
гилофобия (ксилофобия, никтогилофобия, хилофобия) — боязнь леса, заблудиться в лесу
гимнофобия — боязнь наготы
гинекофобия (гинефобия, гинофобия) — боязнь женщин
гипенгиофобия (хипенгиофобия) — боязнь взять на себя ответственность
гипнофобия — боязнь заснуть
гнозиофобия (эпистемофобия) — боязнь знания/познания
гомофобия (гомофобия) — боязнь любого проявления гомосексуальности
гравидофобия — боязнь встречи с беременной, беременности
графофобия — боязнь писа́ть или брать в руки письменные принадлежности
декстрофобия — боязнь вещей, расположенных справа
демонофобия (cатанофобия) — боязнь Дьявола, демонов и другой нечистой силы
демофобия (охлофобия) — боязнь скопления людей, толпы
дентофобия (одонтофобия) — боязнь стоматологов, лечения зубов
дерматопатофобия (дерматофобия, дерматосиофобия) — боязнь заболеть кожной болезнью
децидофобия — боязнь принимать решения
дисморфофобия — боязнь физических недостатков в собственной внешности
дорофобия — боязнь получать или делать подарки
зоофобия — боязнь животных
земмифобия — боязнь кротов
игрофобия — боязнь игр;
инсектофобия (энтомофобия) — боязнь насекомых; частный случай зоофобии
иерофобия — боязнь предметов религиозного культа
иофобия — боязнь ядов
калифобия — боязнь красоты
канцерофобия (канкрофобия, карциномофобия, карцинофобия, кацерофобия) — боязнь заболеть раком, злокачественной опухолью
кардиопатофобия (кардиофобия) — боязнь сердечного заболевания
катагелофобия — боязнь насмешки
кенофобия — боязнь больших незаполненных пространств (например, пустого зала театра)
кинофобия (канинофобия) — боязнь собак
клаустрофобия — боязнь замкнутого пространства
клептофобия — боязнь украсть, либо страх быть обокраденным
климакофобия (климактофобия) — боязнь ходьбы по лестнице, лестниц
коинофобия — боязнь заходить в помещение, где находится много людей
компьютерофобия — боязнь компьютеров
копофобия — боязнь переутомиться
копрофобия — боязнь фекалий
коулрофобия — боязнь клоунов
ксенофобия — страх или ненависть к кому-либо или чему-либо чужому, незнакомому, непривычному
кремнофобия — боязнь смотреть в бездну, пропасть
кристаллофобия — боязнь прикосновения к стеклянным предметам
лалофобия — боязнь говорить из-за опасения возможного заикания
латерофобия — боязнь лежать на боку, чаще — на левом (когда присутствует кардиофобия)
лепрофобия — боязнь заразиться лепрой
лисофобия — боязнь заболеть бешенством
логофобия (глоссофобия) — страх говорить
люофобия (сифилофобия) — боязнь заразиться сифилисом
маниофобия — боязнь психически заболеть
мегалофобия — боязнь больших предметов или объектов
менофобия — боязнь менструаций и связанных с ними неприятных ощущений
металлофобия — боязнь металлических предметов и металлов
мизофобия (гермофобия) — боязнь заразиться инфекционным заболеванием, грязи, прикосновения к окружающим предметам
мирмекофобия — боязнь муравьёв; частный случай зоофобии
морфинофобия — боязнь стать морфинистом
мусофобия (сурифобия) — боязнь мышей и крыс
некрофобия — боязнь трупов и похоронных принадлежностей
неофобия — боязнь нового, перемен
никтофобия (ахлуофобия, скотофобия, эклуофобия) — боязнь темноты, ночи
номофобия — боязнь остаться без мобильного телефона, без связи
нозофобия — боязнь заболеть
омброфобия — боязнь попасть под дождь
онанофобия — боязнь вредных последствий онанизма
орнитофобия — боязнь птиц; частный случай зоофобии
офидиофобия (англ.), или офиофобия — боязнь змей; частный случай герпетофобии
охлофобия — боязнь толпы
панофобия (панфобия, пантофобия) — боязнь всего или постоянный страх по неизвестной причине
паразитофобия — боязнь насекомых-паразитов
паралипофобия — боязнь, что собственные ошибочные действия причинят вред близким родственникам
параскаведекатриафобия (фриггатрискаидекафобия) — боязнь пятницы, 13-го дня месяца
патройофобия — боязнь наследственности, в особенности наследственных заболеваний
парурез — боязнь мочеиспускания на людях
педиофобия — боязнь предметов, имитирующих человеческий облик (кукол, восковых фигур)
педофобия — навязчивый страх детей или имитирующих их изделий (кукол)
пейрафобия — боязнь публичного выступления
пеладофобия — боязнь облысения
петтофобия — боязнь неудержания газов в присутствии посторонних людей
пирофобия — боязнь огня, пожаров, гибели от огня
психрофобия — боязнь холода
рабдофобия — боязнь наказания
радиофобия — боязнь радиации
ранидофобия — боязнь лягушек
ректофобия — боязнь не иметь стула
рипофобия — боязнь грязи, нечистот
робофобия — страх по отношению к любой робототехнике
селахофобия — боязнь акул
сидеродромофобия — боязнь езды в железнодорожном транспорте
ситофобия — боязнь приёма пищи
скабиофобия — боязнь заболеть чесоткой
сколецифобия — боязнь червей, заразных насекомых; частный случай зоофобии
скопофобия (англ.) (скоптофобия) — боязнь пристального разглядывания другими
сомнифобия — боязнь спать
социофобия — боязнь общества, контактов, неловкого поведения в обществе, оценки окружающими
спектрофобия — боязнь призраков
спермофобия — боязнь микробов
спидофобия — боязнь заразиться СПИДом
cтазобазофобия — боязнь стояния и ходьбы
табофобия — боязнь заболеть спинной сухоткой
талассофобия — боязнь моря (в том числе купания и морских путешествий)
танатофобия — боязнь смерти
тафофобия (тафефобия) — боязнь быть погребенным заживо, похорон
телефонофобия — боязнь телефона, ожидания телефонного звонка
терророфобия — боязнь терроризма
тениофобия — боязнь заразиться глистами
теофобия — боязнь бога, его вмешательства в судьбу или кары
термофобия — боязнь жары и натопленных помещений
тетрафобия — боязнь числа 4
токофобия (малевзиофобия) — страх перед родами
токсикофобия — боязнь отравления
топофобия — боязнь остаться одному в помещении
травматофобия — боязнь травмы
трансфобия — боязнь и, как следствие, неприятие и негативная реакция на проявления трансгендерности
тремофобия — боязнь дрожания
трипанофобия — боязнь игл и уколов
трипофобия — страх перед кластерными отверстиями (не признана в Диагностической Американской Психиатрической Ассоциации).
трискайдекафобия (тредекафобия, тердекафобия) — боязнь числа 13
туннелефобия — боязнь прохождения через туннель
уранофобия — боязнь смотреть в небо
фагофобия — боязнь глотания, подавиться пищей
фазмофобия — боязнь призраков и духов
фармакофобия — боязнь принимать лекарства
филофобия — боязнь влюбиться
фобофобия (фобиофобия) — боязнь фобий (страхов), появления симптомов страха, боязнь испытать испуг
хайрофобия — боязнь появления чувства веселья в неподобающей обстановке
харпаксофобия (гарпаксофобия) — боязнь разбойников, быть ограбленным
хемофобия — боязнь химии
хироптофобия — боязнь летучих мышей; частный случай зоофобии
хоплофобия (гоплофобия) — боязнь оружия
хрематофобия — боязнь прикосновения к деньгам
хроматофобия (хромофобия) — боязнь какого-либо цвета и окрашенных в него предметов
хронофобия — боязнь времени
эйсоптрофобия (спектрофобия) — боязнь собственного отражения в зеркале
эйхофобия — боязнь произносить или выслушивать добрые пожелания
эквинофобия (англ.)(гиппофобия) — боязнь лошадей; частный случай зоофобии
эметофобия — боязнь появления рвоты
эпистаксофобия (эпистаксиофобия) — боязнь носового кровотечения
эргазиофобия (англ.) — боязнь оперировать (у врачей-хирургов)
эргофобия — боязнь работать, совершать какие-либо действия
эритрофобия (англ.) (эрейтофобия) — боязнь покраснения лица (боязнь покраснеть на людях)
эротофобия — боязнь секса или вопросов о сексе
эфебифобия — боязнь подростков
ятрофобия — боязнь врачей